$ANSIBLE_VAULT;1.1;AES256
30663064373136326131623366633566393035633165303234653531626439633765353837623039
3533396331393039666631326631313364663130336631300a656534316536613963613266326566
31653536396437373535396532366164653434313435323865663966323238666131616234653464
3939383938626533390a653764653334333561366435313763616534353239613161303632633535
38383536616637636538373432626631663032663439343438376563326332623562396235626666
30346432303765326136343631313837356234346633643263303236666533313535653262386464
35313463393666313833326433336665653361356166643966643966353865333530386564613431
66326662323638353866323861303838313434616666373534663563396430306136633262396434
66386632373136623434343064333435376536616136616433333866333662333530333663313462
36333532303435646432316339653736336636373863633761326230666335346563626536653830
62663031393333366332303430633930383332376362376237373065653265333637323433656462
32386232333936656539
